######B##
###### ##
###### ##
###### ##
###### ##
#####  ##
##### ###
##### ###
##### ###
      ###
 ########
A#######