## ###B##
## ### ##
## ### ##
## ### ##
## ### ##
##     ##
##### ###
##### ###
##### ###
      ###
 ## #####
 ## A####